1111111111
1C0P00CE01
1111111111