11111111111111111
100P0000000000001
10000000000000001
100000C0000000001
10000000000000001
10000000000000001
100000000000E0001
11111111111111111