1111111111
100ECP0001
11111111