1111111111
100ECP0001
1111111111