11111111
10CP0001
10000011
100000E1
11111111