1111111111
10P0000001
1000000C01
1000E00001
1000000C01
1111111111