11111111111111111
11111PE01C1111111