11111111111111111
1P000000000000001
10000000000000001
100000000000C0001
10000000000000001
1000C000000000001
10000000000000001
1000C000000000001
100000000000000E1
11111111111111111