11111111111111111
10000000000000001
10000000000000001
10P000C0000000001
10000000000000001
10000000000000001
10000000000000001
10000000100000001
10000000100000001
10000000100000001
100000000000E0001
11111111111111111