11111111111111111111111111111
111111P0000000000000C00000001
11111100000000000000000000001
11111100000001111111000000001
10000000000000000000000000001
10000000000C00000111111110001
100000000000000001C0000000001
10000000000000000111000000001
10000111000000000001000000001
101111C1110000000001000000001
10000000011111111111000000001
10000000000000000E10000000001
11111111111111111111111111111