1111111111111111111111111111111111
1C0010P0000000000000C0000000010C01
1110100000000000000000010000010001
1000000010000111111111111100011001
11111111100001C00000010C01100000011
100C00001000011111110100001000001
1000000010000000000001000000000001
1000000000000001111101111111100111
1111111110001111C000010C0000000001
1000000000000001111111011111111101
10C000000000000001C000001000000001
1000000111111101111111111000100001
10000111C0000001111100000C00100001
101111C1110001C1111100111111100001
1000000001111111111101100000000001
10000000000000000E1C01000C00000001
1111111111111111111111111111111111